1111111111111
10010000000C1
1T00011111001
1P0011E0000T1
1111111111111